MMMMMMMMMMMMMMMMMMMMM
M....S....M....S....M
M.MM.MMMM.M.MMMM.MM.M
M.......M.M.M.....M.M
M.MMMMM.M.M.M.MMMMM.M
M.M.....M.D.M.....M.M
M.M.MMMMMMMMMMMMM.M.M
M.M..MFFFFFFFFFM..M.M
M.MM.MFFFFFFFFFM.MM.M
M.MM.MFFFFFFFFFM.MM.M
M..M.MFFFFFFFFFM.M..M
MM.M.MMMMMMMMMMM.M.MM
MM.................MM
MM.M.MM.MMMMM.MM.M.MM
MM.M......P......M.MM
MM.M.MMMM.M.MMMM.M.MM
MS.M......M......M.SM
M.MM.MMMM.M.MMMM.MM.M
M.........M.........M
MMMMMMMMMMMMMMMMMMMMM