MMMMMMMMMMMMMMMMMMMMM
M..M.............M..M
MM.M.MMM.MMM.MMM.M.MM
M....MMM.....MMM....M
M.MM.....MMM.....MM.M
M.MM.MMMMMMMMMMM.MM.M
M....M.........M....M
M.MMMMVMMMMMMMVMMMM.M
M.M..VVVVVVVVVVV..M.M
M...MMVVVVVVVVVMM...M
M.M.MMVVVVVVVVVMM.M.M
M...VVVVVVVVVVVVV...M
M.M.MMVVVVVVVVVMM.M.M
M.M.VVVVVVVVVVVVV.M.M
M.M.MM.MMMMMMM.MM.M.M
M.M......MMM......M.M
M...MMMM..P..MMMM...M
MMM.MMMMMMMMMMMMM.MMM
M...................M
M.MMMM.M.MMM.M.MMMM.M
M......M.....M......M
MMMMMMMMMMMMMMMMMMMMM