MMMMMMMMMMMMMMMMMMMMM
M....S....M....S....M
M.MM.MMMM.M.MMMM.MM.M
M.......M.M.M.....M.M
M.MMMMM.M.M.M.MMMMM.M
M.M.....M...M.....M.M
M.M.MMVMMMMMMMVMM.M.M
M.M..MVVVVVVVVVM..M.M
M.MM.MVVVVVVVVVM.MM.M
M.MM.VVVVVVVVVVV.MM.M
M..M.MVVVVVVVVVM.M..M
MM.M.MMMMMMMMMMM.M.MM
MM.................MM
MM.M.MM.MMMMM.MM.M.MM
MM.M......P......M.MM
MM.M.MMMM.M.MMMM.M.MM
MS.M......M......M.SM
M.MM.MMMM.M.MMMM.MM.M
M.........M.........M
MMMMMMMMMMMMMMMMMMMMM