MMMMMMMMMMMMMMMMMMMMM
M..M.............M..M
MM.M.MMM.MMM.MMM.M.MM
M....MMM.....MMM....M
MSMM.....MMM.....MMSM
M.MM.MMMMMMMMMMM.MM.M
M....M.........M....M
M.MMMMMMMMMMMMMMMMM.M
M.M..MFFFFFFFFFM..M.M
M...MMFFFFFFFFFMM...M
M.M.MMFFFFFFFFFMM.M.M
M...MMFFFFFFFFFMM...M
M.M.MMFFFFFFFFFMM.M.M
M.M.MmFFFFFFFFFMM.M.M
MSM.MMMMMMMMMMMMM.MSM
M.M......MMM......M.M
M...MMMM..P..MMMM...M
MMM.MMMMMMMMMMMMM.MMM
M...................M
M.MMMM.M.MMM.M.MMMM.M
M......M.....M......M
MMMMMMMMMMMMMMMMMMMMM